Hidrogênio - H
Hélio - He
Lítio - Li
Berílio - Be
Boro - B
Carbono - C
Nitrogênio - N
Oxigênio - O
Flúor - F
Neônio - Ne
Sódio - Na
Magnésio - Mg
Alumínio - Al
Silício - Si
Fósforo - P
Enxofre - S
Cloro - Cl
Argônio - Ar
Potássio - K
Cálcio - Ca
Escândio - Sc
Titânio - Ti
Vanádio - V
Cromo - Cr
Manganês - Mn
Ferro - Fe
Cobalto - Co
Níquel - Ni
Cobre - Cu
Zinco - Zn
Gálio - Ga
Germânio - Ge
Arsênio - As
Selênio - Se
Bromo - Br
Criptônio - Kr
Rubídio - Rb
Estrôncio - Sr
Ítrio - Y
Zircônio - Zr
Nióbio - Nb
Molibdênio - Mo
Tecnécio - Tc
Rutênio - Ru
Ródio - Rh
Paládio - Pd
Prata - Ag
Cádmio - Cd
Índio - In
Estanho - Sn
Antimônio - Sb
Telúrio - Te
Iodo - I
Xenônio - Xe
Césio - Cs
Bário - Ba
Lantânio - La
Cério - Ce
Praseodímio - Pr
Neodímio - Nd
Promécio - Pm
Samário - Sm
Európio - Eu
Gadolínio - Gd
Térbio - Tb
Disprósio - Dy
Hôlmio - Ho
Érbio - Er
Túlio - Tm
Itérbio - Yb
Lutécio - Lu
Háfnio - Hf
Tântalo - Ta
Tungstênio - W
Rênio - Re
Ósmio - Os
Irídio - Ir
Platina - Pt
Ouro - Au
Mercúrio - Hg
Tálio - Tl
Chumbo - Pb
Bismuto - Bi
Polômio - Po
Astato - At
Radônio - Rn
Frâncio - Fr
Rádio - Ra
Actínio - Ac
Tório - Th
Protactínio - Pa
Urânio - U
Neptúnio - Np
Plutônio - Pu
Amerício - Am
Cúrio - Cm
Berquélio - Bk
Califórnio - Cf
Einstênio - Es
Férmio - Fm
Mendelévio - Md
Nobélio - No
Laurêncio - Lr
Rutherfórdio - Rf
Dúbnio - Db
Seabórgio - Sg
Bóhrio - Bh
Hássio - Hs
Meitnério - Mt
Darmstádtio - Ds
Roentgênio - Rg
Copernício - Cn
Nihônio - Nh
Fleróvio - Fl
Moscóvio - Mc
Livermório - Lv
Tenesso - Ts
Oganessônio - Og